NO ./textures/wall_2.xpm
SO ./textures/wall_1.xpm
WE ./textures/wall_4.xpm
EA ./textures/wall_3.xpm

C 120,249,241
F 120,30,20

1111111111111111111111111
1000000000110000000000001
1011000001110000000000001
1001000000000000000W00001
1111111110110000011100001
1000000000110000011101111
1111011111111101110000001
1111011111111101110101001
1100000011011101110000001
1000000000000000110000011
1000000000000000110101001
1100000111010101111101111
1111011111101011011110101
1111111111111111111111111

