NO ./textures/bluestone.xpm
SO ./textures/eagle.xpm
WE ./textures/pillar.xpm
EA ./textures/purplestone.xpm

F 184,113,39
C 51,198,227

111111111111111
100010000010001
101010111010101
101010000010101
101011111010101
101000001010101
101111101010101
100000101010101
101110101010101
100010100010001
111010111110111
10S000000000101
111111111111111
