NO ./textures/eagle.xpm
SO ./textures/wood.xpm
WE ./textures/sky_1.xpm
EA ./textures/sprite_1.xpm

F 155,118,111
C 135,206,235

111111111111111
100000000000001
101111101111101
101000001000101
101011101011101
100010000000001
111110111101111
100000101000001
101111101111101
101000000000101
101011111110101
1000000000100S1
111111111111111

